

111111111111111
100100E00100001
100111100100001    
100MC0000C00C01
1000C0M0000C001
1P00C0001000001
111111111111111
    